###########
#         #
#o##### # #
    #   # #
### # ### #
#     #   #
# # ### ###
# #   #    
# ### # # #
#     #   #
###########

